[Atlas_info]
/atlas/Tileset.png
1280 630
64 64
20 20
[ID_matrix]
61 62 63 80 81 82 83 -1 -1 -1 61 62 63 -1 1 2 -1 -1 61 62
81 82 83 100 101 102 103 -1 -1 80 81 82 83 -1 21 22 -1 80 81 82
101 102 103 5 121 122 50 51 5 100 101 102 103 -1 41 42 -1 100 101 102
121 122 5 -1 141 142 70 71 -1 120 121 122 -1 5 61 62 63 120 121 122
141 142 -1 -1 8 -1 49 -1 -1 -1 141 -1 -1 80 81 82 83 -1 141 1
-1 -1 -1 9 -1 -1 -1 -1 -1 8 -1 -1 -1 100 101 102 103 11 12 21
-1 -1 -1 -1 -1 -1 -1 -1 -1 -1 -1 -1 9 120 121 122 123 31 32 41
-1 -1 30 -1 -1 -1 -1 -1 -1 -1 -1 120 -1 -1 141 142 -1 -1 -1 61
-1 -1 48 -1 -1 5 -1 43 -1 -1 -1 30 -1 50 51 -1 -1 30 80 81
-1 -1 -1 -1 -1 -1 -1 -1 -1 8 -1 -1 -1 70 71 43 -1 -1 100 101
-1 -1 8 -1 30 -1 -1 -1 48 -1 -1 48 -1 -1 -1 -1 -1 9 120 121
-1 -1 -1 -1 -1 -1 -1 -1 -1 -1 -1 -1 8 -1 -1 -1 -1 -1 66 141
-1 -1 -1 43 -1 -1 -1 -1 -1 -1 -1 -1 -1 -1 -1 48 -1 -1 86 87
-1 -1 -1 -1 -1 -1 -1 48 -1 6 7 -1 -1 9 -1 -1 5 -1 -1 46
11 12 50 51 -1 -1 -1 -1 -1 26 27 -1 -1 -1 -1 -1 -1 -1 -1 -1
31 32 70 71 24 25 -1 -1 -1 -1 -1 -1 -1 24 25 -1 50 51 -1 0
-1 -1 5 -1 44 45 -1 0 -1 -1 -1 -1 -1 44 45 -1 70 71 -1 20
12 -1 -1 -1 64 65 -1 20 -1 -1 50 51 -1 64 65 -1 -1 -1 -1 40
32 0 -1 8 5 -1 -1 40 -1 -1 70 71 -1 -1 -1 1 2 -1 -1 60
-1 20 -1 -1 -1 -1 -1 60 -1 -1 11 12 -1 -1 -1 21 22 7 -1 -1
