[Atlas_info]
/atlas/Tileset.png
1280 630
64 64
20 20
[ID_matrix]
-1 -1 -1 -1 108 109 110 111 -1 -1 -1 -1 -1 -1 108 109 110 111 -1 -1
88 89 90 91 -1 -1 -1 -1 -1 -1 -1 130 -1 -1 -1 -1 -1 -1 88 89
108 109 110 111 -1 -1 -1 130 -1 -1 128 129 -1 -1 -1 -1 -1 -1 108 109
-1 -1 -1 -1 -1 -1 -1 -1 -1 -1 148 149 -1 -1 88 89 90 91 -1 -1
-1 -1 -1 130 -1 -1 -1 88 89 91 -1 -1 -1 -1 108 109 110 111 -1 88
-1 -1 -1 -1 -1 -1 -1 108 109 111 -1 -1 -1 130 -1 -1 -1 -1 -1 108
88 89 90 90 90 91 -1 -1 -1 -1 -1 -1 -1 -1 -1 -1 -1 -1 -1 -1
108 109 110 110 110 111 -1 -1 -1 -1 -1 -1 -1 -1 -1 -1 -1 -1 -1 -1
-1 -1 -1 -1 -1 -1 -1 -1 -1 -1 -1 -1 -1 -1 -1 -1 -1 -1 -1 -1
-1 -1 -1 -1 -1 -1 -1 -1 -1 -1 -1 -1 -1 -1 -1 -1 -1 -1 -1 -1
-1 -1 -1 -1 -1 -1 -1 -1 -1 -1 -1 -1 -1 -1 -1 -1 -1 -1 -1 -1
-1 -1 -1 -1 -1 -1 -1 -1 -1 -1 -1 -1 -1 -1 -1 -1 -1 -1 -1 -1
-1 -1 -1 -1 -1 -1 -1 -1 -1 -1 -1 -1 -1 -1 -1 -1 -1 -1 -1 -1
-1 -1 -1 -1 -1 -1 -1 -1 -1 -1 -1 -1 -1 -1 -1 -1 -1 -1 -1 -1
-1 -1 -1 -1 -1 -1 -1 -1 -1 -1 -1 -1 -1 -1 -1 -1 -1 -1 -1 -1
-1 -1 -1 -1 -1 -1 -1 -1 -1 -1 -1 -1 -1 -1 -1 -1 -1 -1 -1 -1
-1 -1 -1 -1 -1 -1 -1 -1 -1 -1 -1 -1 -1 -1 -1 -1 -1 -1 -1 -1
-1 -1 -1 -1 -1 -1 -1 -1 -1 -1 -1 -1 -1 -1 -1 -1 -1 -1 -1 -1
-1 -1 -1 -1 -1 -1 -1 -1 -1 -1 -1 -1 -1 -1 -1 -1 -1 -1 -1 -1
-1 -1 -1 -1 -1 -1 -1 -1 -1 -1 -1 -1 -1 -1 -1 -1 -1 -1 -1 -1
