[Atlas_info]
/atlas/Tileset.png
1280 630
64 64
20 20
[ID_matrix]
-1 -1 -1 -1 -1 -1 -1 -1 -1 -1 -1 -1 -1 -1 -1 -1 -1 -1 -1 -1
-1 -1 -1 -1 -1 -1 -1 -1 -1 -1 -1 -1 -1 -1 -1 -1 -1 -1 -1 -1
14 14 14 14 14 14 14 14 14 14 14 14 14 14 14 14 14 14 14 14
34 34 35 36 36 36 36 36 36 36 36 36 36 36 37 34 34 34 34 34
34 34 55 56 56 56 56 56 56 56 56 56 56 56 57 34 34 34 34 34
34 34 55 56 56 56 56 56 56 56 56 56 56 56 57 34 34 34 34 34
34 34 55 56 56 56 56 56 56 56 56 56 56 56 57 34 34 34 34 34
34 34 55 56 56 56 56 56 56 56 56 56 56 56 57 34 34 34 34 34
34 34 55 56 56 56 56 56 56 56 56 56 56 56 57 34 34 34 34 34
34 34 55 56 56 56 56 56 56 56 56 56 56 56 57 34 34 34 34 34
34 34 75 76 76 76 76 76 76 76 76 76 76 76 77 34 34 34 34 34
34 34 34 34 34 34 34 34 34 34 34 34 34 34 34 34 34 34 34 34
34 34 34 34 34 34 34 34 34 34 34 34 34 34 34 34 34 34 34 34
34 34 34 34 34 34 34 34 34 34 34 34 34 34 34 34 34 34 34 34
34 34 34 34 34 34 34 34 34 34 34 34 34 34 34 34 34 34 34 34
34 34 34 34 34 34 34 34 34 34 34 34 34 34 34 34 34 34 34 34
34 34 34 34 34 34 34 34 34 34 34 34 34 34 34 34 34 34 34 34
34 34 34 34 34 34 34 34 34 34 34 34 34 34 34 34 34 34 34 34
34 34 34 34 34 34 34 34 34 34 34 34 34 34 34 34 34 34 34 34
34 34 34 34 34 34 34 34 34 34 34 34 34 34 34 34 34 34 34 34