[Atlas_info]
/atlas/sheet.png
512 512
70 70
5 10
[ID_matrix]
30 18 18 18 18 45 -1 -1 -1 -1
2 28 28 28 28 9 45 -1 -1 -1
2 28 28 28 28 28 9 45 -1 -1
2 28 28 28 28 28 28 9 45 -1
7 7 7 7 7 7 7 7 7 -1
